best song ever﻿| 	positive
good﻿| 	positive
honestly... this is pathetic.﻿| 	negative
boo heel turn asshole fuck you bitch motherfucker dumbass﻿| 	negative
hey nicki. minaj i have a skimny but and fuck u!!!﻿| 	negative
love you nicki﻿| 	positive
heal you are so disgusting nicki minaj how can you do that﻿| 	negative
1,030,077 great guys !  &lt;3﻿| 	negative
this makes me cry﻿| 	positive
simply beautiful, perfection!﻿| 	positive
oh man, u made me shed tears....touch!!!﻿| 	positive
beautiful. just beautiful.﻿| 	positive
compelling lyrics... nice one!!!﻿| 	positive
im sold. fucking lovely.﻿| 	positive
love you. freaking amazing.﻿| 	positive
some assholes who have no brains disliked this song !!!!!!﻿| 	positive
nice﻿| 	positive
i can&#39;t listen to this song without crying﻿| 	positive
it deserves more dislikes﻿| 	negative
dafk is dis m8?﻿| 	negative
people were right. rebecca black&#39;s friday is shit.﻿| 	negative
girl, work! i love this song, don&#39;t worry about the haters! love you!﻿| 	positive
(•_•) this is so weird <br /> &lt;|&gt;<br />  /\﻿| 	negative
i feel like i now found a bitch!﻿| 	negative
this is the most annoying song in the world﻿| 	negative
the way you say friday is really disturbing﻿| 	negative
this is the shittiest shit i have watched on the whole of youtube﻿| 	negative
i was 11 when this song was created now im 16 wow i still love it﻿| 	positive
im surprised she still hasn&#39;t hung herself.﻿| 	negative
i just disliked because it&#39;s known to be disliked... :]﻿| 	negative
i cry at this video every single time. just beautiful﻿| 	positive
its quite gross cuz his hands on my hair his clothes are in my room but love the song💖💖﻿| 	positive
this reminds me of a lana del ray song﻿| 	positive
oh ı love you taylor swift :)﻿| 	positive
epic !!!!﻿| 	positive
having a personal one to this song, nice touch labrinth bro xx﻿| 	positive
amazing, amazing 😍﻿| 	positive
love it!﻿| 	positive
love it﻿| 	positive
her voice is anoying﻿| 	negative
ugly﻿| 	negative
if you have big butt what we could do dont shake your but you are giving me cancer﻿| 	negative
💪💋👏👏👏﻿| 	positive
i feel so bad for drake lolz also at least better then jb﻿| 	negative
free 1080p porn , i like it..﻿| 	positive
i would look at ur butt when u were at the gym nicki manaj﻿| 	positive
i don&#39;t no why i like this i watch it over and over again😝😝😝😝﻿| 	positive
omg that laugh is giving me nightmares!﻿| 	negative
don&#39;t my anaconda﻿| 	negative
stupid song miki﻿| 	negative
crazy song :)﻿| 	positive
this porn have iteresting music﻿| 	negative
this is what people are listening to now as &quot;rap&quot; music? sad.﻿| 	negative
this is our &quot;culture&quot;? omfg!﻿| 	negative
she fuck up this classic jam smh 😳👎.﻿| 	negative
what a crock of shite﻿| 	negative
lol :d<br />my anaconda&#39;s awake :-p﻿| 	positive
i like your ass﻿| 	positive
too explicit xd﻿| 	negative
you are with me..﻿| 	positive
i like you !﻿| 	positive
cute﻿| 	positive
i love this video!! <b><i>___</i></b>﻿| 	positive
i love this song﻿| 	positive
:&#39;)<br />you make me cry﻿| 	positive
this song makes me so emotional. breaks my heart.﻿| 	positive
i just wanna hug labrinth and tell him that everything&#39;s gonna be alright...﻿| 	positive
great ! i like this song﻿| 	positive
but he looks super hot .i cant deny﻿| 	positive
eyes 😍😍😍😍😍😍😍😍﻿| 	positive
lo ame! 😍﻿| 	positive
what&#39;s sid from ice age doing there?﻿| 	positive
she is so sexy!﻿| 	positive
cool﻿| 	positive
i don&#39;t even give a fuck any more i like justin&#39;s music﻿| 	positive
your songs suck﻿| 	negative
awesome song! love you small peanut! :)﻿| 	positive
i&#39;m slapping the next kid i see with this haircut﻿| 	negative
this song is ok﻿| 	positive
two lesbians making out is hawttt...keep it up justin﻿| 	positive
gay lord﻿| 	negative
he looks like miley cyrus with that hairstyle 😂😂😂﻿| 	negative
its like a sex tape﻿| 	positive
so very well sung justin bieber.  very talented﻿| 	positive
this stuff is hot men﻿| 	positive
woah 1 mil likes!!??!??!?﻿| 	positive
ewwwwwwww is not good !!﻿| 	negative
i like it :)﻿| 	positive
amazin track in a time﻿| 	positive
im lovin it awsome song jb not a fan but now i am﻿| 	positive
fuck my brother looks like that faggot fffffffuuuuuuuuuuccccccccckkkkkkkkkk﻿| 	negative
shoot a canadian save a puppy !!﻿| 	negative
good song👍🏻﻿| 	positive
this is great... everyone click on my channel and watch my adventure video also 😍 thumbs up please﻿| 	positive
how i wish i am that girl in the mv... =.= :)﻿| 	positive
i&#39;m not a justin beiber fan but i like this song﻿| 	positive
amazing﻿| 	positive
i love you justin bieber﻿| 	positive
justin is still a faggot﻿| 	negative
i love justin bieber, dead the deslike﻿| 	positive
❤﻿| 	positive
