who else came here just to dislike the video?﻿| 	negative
the most disliked video in youtube. 5 million dislikes r.i.p﻿| 	negative
this my shit💙﻿| 	positive
5 million dislike is best﻿| 	negative
5 million dislike is best﻿| 	negative
i came to dislike the video with my 3rd account.﻿| 	negative
first video i&#39;ve ever seen with more dislikes than likes 😂😂😂😂﻿| 	negative
can we try to give him 5 200 000 likes and not 3 000 000 cause this shit isn t gamnam style﻿| 	positive
i still like this song even when ppl hates it lol i&#39;m so different from everyone else ☺﻿| 	positive
that dislikesxd﻿| 	negative
love﻿| 	positive
i hate it when people ask for likes.<br /><br />like if you agree.﻿| 	negative
one hit wonder, bieber will never hit 1b views again haha﻿| 	negative
im liking this just cause all you all hate it﻿| 	positive
congrats on the 5 million dislikes guys :d﻿| 	negative
ok wow﻿| 	positive
he seriously looks younger than most 8 year olds﻿| 	negative
tf 5m unlikes 😩﻿| 	negative
love this song...﻿| 	positive
why do people dislike this video?﻿| 	positive
why have none of my russian snipers picked this fucker off yet.﻿| 	negative
lets reach 6 million dislikes guys xd﻿| 	negative
booo﻿| 	negative
suck a dick justin bieber﻿| 	negative
woh 5 million unlikes﻿| 	negative
i came here just to dislike song :d﻿| 	negative
5 mill dislikes hahaha xd most disliked video in the world﻿| 	negative
go justin bieber hart hart﻿| 	positive
and ima huge baby baby baby ooooh﻿| 	negative
jb is son of yhe fucking bitch, i wanna fight with he﻿| 	negative
jastin bieber te amo﻿| 	positive
when she peeked out off the door she looked like cara delevigne﻿| 	positive
i like﻿| 	positive
when she peeked out off the door she looked like cara delevigne﻿| 	positive
i think hes hot and im not a fan but his music is getting better. what a good comeback justin :-)﻿| 	positive
i like justine bieber and selena gomez should be in that video :)<br />:) :)﻿| 	positive
not cool i&#39;m cry:&#39;(﻿| 	negative
stfu justing u and ur fukwit hair and hf dog u cunt﻿| 	negative
he&#39;s ugly and gay﻿| 	negative
she is either on her period of hitting puberty but nice song fluf the haters﻿| 	positive
the last two songs this guy made or been in have been really good﻿| 	positive
i dont liket this song﻿| 	negative
so so good 3 &lt;3 &lt;3﻿| 	positive
she is sad cozof  his small dick﻿| 	negative
this gay shit career is slowly dying fuck yeahh!!!!!!!!!﻿| 	negative
so sad, yet so beautiful <br /><br /> - via ytpak(.com)﻿| 	positive
no words to describe it but simply beautiful﻿| 	positive
xfactor brought me here and stayin﻿| 	positive
i just cnt stop listenin to it &lt;3 .. luv it so bad &lt;3﻿| 	positive
makes me cry every single time -and that&#39;s not always a bad thing .. thanx &lt;3﻿| 	positive
this guy is a phreakin legend. all i have to say..﻿| 	positive
he sounds like a chocking 5 year old﻿| 	negative
this song is the best thing that&#39;s ever happened﻿| 	positive
love &lt;3﻿| 	positive
love justin bieber forever &lt;3﻿| 	positive
i love it,  the emotion,  the passion, the truth in the words.  beautiful!﻿| 	positive
love this song labrinth, bring tears to my eyes every time i hear it.﻿| 	positive
these hot parts are always in  all songs﻿| 	positive
i think right now is my favourite song.﻿| 	positive
beautiful. voice of an angel 😍﻿| 	positive
relatable...tears﻿| 	positive
to my beautiful baby sister up there in heaven...﻿| 	positive
lovely song i like it﻿| 	positive
linda musica.﻿| 	positive
nick jonas brought me here. not regretting﻿| 	positive
amaziiiing!! fantastic!! roumanie!!﻿| 	positive
im 10 and when i saw this i felt like punching whole. through my computer like flappybird﻿| 	negative
we get it it&#39;s friday now shut up﻿| 	negative
i love this song !!!❤️❤️👌🏼😄✋🏻✋🏻🎶👏🏻👏🏻👏🏻👏🏻💗﻿| 	positive
your very pretty﻿| 	positive
this is awfu,l i mean awful<br />even the words﻿| 	negative
this is sssoooo annoying﻿| 	negative
this bitch needs to litrerally die﻿| 	negative
these are the kinds of videos that gets schools shot up﻿| 	negative
5 years later i&#39;m watching this and it&#39;s still shit.....﻿| 	negative
i hate how she says friday it&#39;s like fraiday fraiday i can fucking sing its freyevbcghjcnghfday﻿| 	negative
this is the most annoying song in the world﻿| 	negative
if her fridays are like this imagine her saturdays @__@﻿| 	negative
give me a hammer.﻿| 	negative
biggest fucking aids song ever you topped bieber mate﻿| 	negative
