(•_•)<br /> (   )<br />that was the worst singing ever﻿| 	negative
why am i not watching porn?﻿| 	negative
this is so terrible kill urself﻿| 	negative
wtf did i just watch? now ill never get this fking song outa my ears, any solution?﻿| 	negative
niggewr god  dam song﻿| 	positive
i don&#39;t mind the song it&#39;s funny﻿| 	positive
this song is very annoying and it sucks.﻿| 	negative
it&#39;s already been 4 years since this abomination was released huh? i feel old now.﻿| 	negative
so beautiful﻿| 	positive
worst vid ever﻿| 	negative
these girls in the music video aint even pretty﻿| 	negative
surprisingly her voice is the worst part﻿| 	negative
waiting for bart to make a parody of this song...﻿| 	negative
taylor swift is really hot﻿| 	positive
like a song﻿| 	positive
like!!!!!!﻿| 	positive
love this💘💘💘💘﻿| 	positive
that is so sweet :d :d:d﻿| 	positive
i liek dis sang!﻿| 	positive
i like﻿| 	positive
love you swift﻿| 	positive
good song! i love it! <b>-</b>﻿| 	positive
beautiful music﻿| 	positive
^^﻿| 	positive
it´s not gay if it is in a 3 way﻿| 	positive
can&#39;t stop listening this song...﻿| 	positive
very perfect﻿| 	positive
why is she holding her tummy is she pregnant﻿| 	negative
love this song﻿| 	positive
no matter how many times i watch this video, it just gets me everytime...﻿| 	positive
omg jutin please make a new song it been 2years we need a new song from u!﻿| 	positive
september 2015...  this song is a classic.  still make me cry 😢﻿| 	positive
nice songs justin﻿| 	positive
when is so sad﻿| 	negative
the best😍﻿| 	positive
reminds me of my boyfriend every time i hear this 😩﻿| 	negative
she is beautiful even her hair is black :)﻿| 	positive
she knows what every girl thinks.. god ..genius!﻿| 	positive
this sucks﻿| 	negative
this is such a beautiful video!﻿| 	positive
this man looks like james dean, almost)﻿| 	positive
why the fuck am i here?﻿| 	negative
this song kills my ears﻿| 	negative
love this song﻿| 	positive
i luv those blue eyes﻿| 	positive
trying to be halsey and lana so hard﻿| 	negative
this is fantastic.....﻿| 	positive
this is really cheesy﻿| 	negative
okay that was great﻿| 	positive
wow it&#39;s so pretty﻿| 	positive
the song has a strong lana del rey feel.﻿| 	positive
:))))))))))))))﻿| 	positive
scott eastwood... what can you say but wow﻿| 	positive
bullshit﻿| 	negative
thanks you labrith. this song so touching﻿| 	positive
i have completely fallen in love with his voice, this song is amazing.﻿| 	positive
it&#39;s very emotional.﻿| 	positive
seriously too beautiful﻿| 	positive
nice video﻿| 	positive
this is a very very very beautiful song.  i can&#39;t get enough of you.﻿| 	positive
this is exactly how i feel towards you ian. i love you and miss you so much baby boy. xx﻿| 	positive
his voice and the lyrics are beautiful i&#39;m so glad i clicked the video﻿| 	positive
woow mate,you can put me think and cry ;( the best :d ﻿| 	positive
labrinth deserves a grammy for this song its one of the most beautiful songs in the world﻿| 	positive
this is a beautiful song.. definitely remembering this one. &lt;3﻿| 	positive
i cried so hard hearing this song in xfactor loll, this is amazing.﻿| 	positive
this song is a punch in the heart i don&#39;t know why its not popular...﻿| 	negative
i love it!!! xx﻿| 	positive
it makes me think of my baby sometimes﻿| 	positive
xfactor made me do it after watching the boy i stay watching 😍﻿| 	positive
wauw its soo beautifull﻿| 	positive
this sad song :(﻿| 	positive
amazing﻿| 	positive
song gives me goosebumps.﻿| 	positive
love you labyrinth ﻿| 	positive
amazing voice and song.﻿| 	positive
10 mill views only ??﻿| 	positive
josh daniel brought me here... this song will now forever be a different experience for me﻿| 	positive
love this song !!!﻿| 	positive
a definite feels song﻿| 	positive
published on halloween!!! btw i love this song! :3﻿| 	positive
i like it﻿| 	positive
80% porn   10%swearing 10% music like wtf﻿| 	negative
porn nice﻿| 	positive
sexy :)﻿| 	positive
yass﻿| 	positive
:   )﻿| 	positive
this is stupid 😐﻿| 	negative
sexy﻿| 	positive
lol﻿| 	negative
sexy.﻿| 	positive
bad move miley bad move﻿| 	negative
queen﻿| 	positive
worst ever video clip﻿| 	negative
how stupid﻿| 	negative
i love you﻿| 	positive
&lt;3﻿| 	positive
ugh <br /><b>slut!</b>﻿| 	negative
&lt;3 ^_^﻿| 	positive
i love her﻿| 	positive
beautiful song﻿| 	positive
👌 perfectt﻿| 	positive
song beautiful﻿| 	positive
one of my favs﻿| 	positive
shes ugly﻿| 	negative
this never gets old to me 😍😍﻿| 	positive
i love you music rihanna﻿| 	positive
nice song....rihana you are so cute﻿| 	positive
bad﻿| 	negative
nice song about friendship.. :)﻿| 	positive
roll on still listening to u in 2015 every time it rains :-)﻿| 	positive
i love heeeeeeeeeerrrrrrrrrr &lt;3 shes so beautiful﻿| 	positive
l love music &quot;umbrella &quot; 😍﻿| 	positive
old but gold song !﻿| 	positive
nice﻿| 	positive
this video is perfect exept jay z :( :)﻿| 	positive
i hâte the song﻿| 	negative
satan in à youtube﻿| 	negative
